++++++++++++++++++++++
+       ++   +      +
+     +        +++++++
+ +    ++  +++  +++ ++
+ +   + + ++    +++  +
+          ++  ++  + +
+++++ + +      ++  + +
+++++ +++  + +  ++
+          + + S+    +
+++++ +  + + +     + +
++++++++++++++++++++++